User Name	Password	Name	Email
Dev	Dev	Dev Qol	dev@develop.ura
ui3passel	kFZJV93egcyW	Tripp Campos	jared87@goldner.net
ui3sandpiper	Rc7cq2CZCrSH	Titus Ali	pablo67@lakin.com
popui3	2E2aSyn9nHP6	Jaycee Palmer	demetris38@hotmail.com
ui3sent	hxvJRBBkBBnk	Douglas Paul	amber.herzog@gmail.com
ui3qualify	L9rETrnQfayt	Sarahi Goodman	kenna.terry@shields.com
ui3obsequious	vVzGy5Mze9c3	Micah Porter	marie.wehner@hotmail.com
woodchuckui3	XWUtM4R2Txp7	Cruz Oneal	arielle14@bayer.com
ui3guardian	2acFpGWRnVrd	Janet Bush	marcus32@zboncak.com
allowui3	C8eteZpufVwY	Leroy Craig	towne.fleta@gmail.com
melodicui3	BWZreqPnP3pZ	Beau Lynn	sjacobson@yahoo.com
ui3obsidian	y6x76HCvLXGQ	Maverick Irwin	wdicki@harvey.com
aquaui3	mSykrpvgksqC	Emmanuel Khan	maggio.hardy@gmail.com
ui3colorful	LLqnh5G9KA3x	Reese Ibarra	witting.triston@paucek.com
violationui3	eyW3YDf2n2pe	Gilbert Singh	jillian20@gaylord.com
fearlessui3	w6BERrsmSQHD	Abigail Cole	borer.raymond@gmail.com
ui3utsire	LGdYkRxT7mCw	Tanner Ritter	reichert.garrett@gmail.com
ui3wellies	3DVjSBfy2wDq	Eliza Frey	emard.norval@gmail.com
ui3enormous	KGefSgfmuR8z	Tyrone Grant	ukunde@yahoo.com
powerh3if0x	GgQHny6aba6A	Janiah Galvan	aiden.metz@hermiston.com
insighth3if0x	Q8UC5HGgk3Fu	Raelynn Chandler	eheaney@konopelski.com
clienth3if0x	8aaCMTehqKrA	Dorian Wolf	hintz.joannie@gmail.com
h3if0xmen	FCjqXfUsNYMe	Rayne Mays	kerluke.bobby@runolfsson.com
siteh3if0x	N2u86AERpZqw	Moses Ramsey	claudia.mayert@klein.net
denseh3if0x	WtZbMkUS4FyH	Anne Cantu	emmy82@hotmail.com
dashingh3if0x	ahzjhWG5aAdY	Keagan Higgins	eulah94@hotmail.com
